00000000000
01111111110
01100001010
01000000010
01100000010
01001010010
01001000010
01001110110
01000000010
01111111110
00000000000
