10000000000111
10111111111111
10110060101111
10100070031111
10110000001111
10100010101111
10140010001111
10100311011111
10100205001111
10111111111111
10000000000111
10000000000111
10000000000111
10000000000111