100000000001111111111
101111111111111111111
101100601011111111111
101000700311111111111
101100000011111111111
101000101011111111111
101400100011111111111
101003110111111111111
101002050011111111111
101111111111111111111
100000000001111111111
100000000001111111111
100000000001111111111
100000000001111111111
100000000001111111111
100000000001111111111
100000000001111111111
100000000001111111111
100000000001111111111
100000000001111111111
100000000001111111111