00000000000
01111111110
01190601010
01000700310
01100000010
01000101010
01400100010
01003110110
01002050010
01111111110
00000000000