00000000000000
01111111111110
01000060100010
01010070031010
01400001001310
01000100011010
01400100001010
01003111101010
01000005001010
01011111111310
01000000000010
01200555500910
01111111111110
00000000000000