00000000000
01111111110
01000000010
01000000010
01001110010
01000000010
01000000010
01000000010
01000000010
01111111110
00000000000
