000000000000000000000
011111111111111111110
012666616666166666610
014311010000003114310
014031000000003140310
011140000000000031110
014031100000000000310
014031000314003140310
014031431403143140310
014031400000003140310
014031403114003140310
014031400000003140310
014031414031403140310
014031403140000140310
014000000000001140310
011140000000000031110
014031400000003140310
014311400000013114310
015555551555515555910
011111111111111111110
000000000000000000000